कहानी - Story
खरगोश - Rabbit
शेर - Lion
जंगल - Jungle
जानवर - Animal
कुआँ - Well
डर - Fear
समझदारी - Wisdom
संकट - Crisis
बुद्धि - Intelligence
चालाकी - Cunning
समस्या - Problem
समाधान - Solution
छोटे - Small, Younger
बड़े - Large, Elder
सब - All, Everyone
को - To
महत्व - Importance
दो - Give
क्योंकि - Because
जहां - Where
सुई - Needle
का - Of
काम - Work
है - Is
वहां - There
तलवार - Sword
नहीं - Not
करती - Does
बच्चे - Children
खेल - Play
रहे - Are
हैं। - They are.
